000000000000000
000000000000000
000000000000000
000000000000000
333333333333333
111111111111111
222222222222222