000000000000210001
011100010100012012
001000010100000000
001000011100121203
001000010100000323
011001010100000123
000000000000001230
022222222200123120
333333333333333333